PPPPPPPPPPPPPPPPPPPPPPPPPPPPPPPPPPPPPPPPPPPPPPPPPPPPPPPPPPPPPPPPPPPPPPPPPPPPPPPPPPPPPPPPPPPPPPPPPPPPPPPPPPPPPPPPPPPPPPPPPPPPPPPPPPPPPPPPPPPPPPPPPPPPPPPPPPPPPPPPPPPPPPPPPPPPPPPPPPPPPPPPPPPPP
P                                                                                                                                                                                           P
P                                                                                                                                                                                          EP
P                         $                                                                                    L                                                                  S        BP
P                    PPPPPPPPPPP                                                      LL                      LLL$                                  U                        PPPPPPPPPPPPPPPP
P                                                                                  NNNLLL                    LLDLL                                  J                    L                  P
P        S                                                                       PPPPPPPP                      D                             PPPPPPPPPPPP               LLL                 P
P    PPPPPPPP                 S                                                                                D                                                       LLDLL                P
P                   PPPPPPPPPPPPP                                                                      PPPPPPPPPPPPP                                                     D                  P
P                                                                                       Y                                                                    PPPPPPPPPPPPPPPP               P
P                                                                                       H                                                                                                   P
P         PPPPPPP                                                                      PPPPPPPP                                                 S                                           P
P                                                                                             PPPPPPPPP                                      PPPPPPPPPP                                     P
P                     PPPPPP             PPPPPPPP           $                                                 $                                                                             P
P                                                                                                           PPPPPPPP                                                                        P
P       S                                                                                                   P                                               PPPPPPPPPPPPPPP                 P
P   PPPPPPPPPPP                                               S                               PPPPPPPPPPPPPPP                                    P                                          P
P                     L                                  PPPPPPPP                       S     P                                                  P                                          P
P                    LLL                                                             PPPPPPPPPP                                        L       PPPPPPPP                                     P
P                   LLLLL                   T                                                                                         LLL                                                   P
P                     D                     G                                                                                        LLDLL                                   LL  $          P
P                     D                     S                                                         S       S       S                D                                    LLLNNN          P
PPPPPPPPPPPPPPPPPPPPPPPPPPPPPPPPPPPPPPPPPPPPPPPPPPPPPPPPPPPPPPPPPPPPPPPPPPPPPPPPPPPPPPPPPPPPPPPPPPPPPPPPPPPPPPPPPPPPPPPPPPPPPPPPPPPPPPPPPPPPPPPPPPPPPPPPPPPPPPPPPPPPPPPPPPPPPPPPPPPPPPPPPPPPP