PPPPPPPPPPPPPPPPPPPPPPPPPPPPPPPPPPPPPPPPPPPPPPPPPPPPPPPPPPPPPPPPPPPPPPPPPPPPPPPPPPPPPPPPPPPPPPPPPPPPPPPPPPPPPPPPPPPPPPPPPPPPPPPPPPPPPPPPPPPPPPPPPPPPPPPPPPPPPPPPPPPPPPPPPPPPPPPPPPPPPPPPPPPPP
P                                                                                                                                            $                                        Y    EP
P                                                                                                                                           PP                                        H    BP
P                                                                                                                                                                                   PPPPPPPPP
P                                                            $                                        $                                           PPP                  PPPPPP               P
P                                                                                                    PPP                                                                                    P
P                                                                                                                                                                PPP                        P
P                                                        PP                                                                                                                                 P
P                                                                                                                PP                                       PP                                P
P                                                                                                                                              L                                            P
P                                                  PP                                                                                         LLL                                           P
P                                T                                                                                        PPP                DNLLL                                          P
P                                G                                                                                                    $    DNN  LLL                                         P
P                  PPPPPPPPPPPPPPPPPPP       PPPPPPPPPP                                                                            PPPPPPNNN                                                P
P                 PPPPPPPPPPPPPPPPPPPPP      PPPPPPPPPPPP                                                                                                                                   P
P               PPPPPPPPPPPPPPPPPPPPPP        PPPPPPPPPPPP                                                                                                                                  P
P              PPPPPPPPPPPPPPPPP           PPPPPPPPPPPPPPPP                                                                 PP                                                              P
P             PPPPPPPPPPPPPPP           PPPPPPPPPPPPPPPPPPPP                                          U L                                                                                   P
P            PPPPPPPPPPP          $PPPPPPPPPPPPPPPPPPPPPPPPPP                                         JLLL            PP              PPP                                    PPPPPPPPPPPPPPPP
P           PPPPPPPPKKKKKKKKKKKKKKPPPPPPPPPPPPPPPPPPPPPPPPPPPP                                        LLLLL                                                                          $      P
P           PPPPPPPPPKKKKKKKKKPPPPPPPPPPPPPPPPPPPPPPPPPPPPPPPPP                                         D                                                                            PP     P
P    S     PPPPPPPPPPPPPPPPPPPPPPPPPPPPPPPPPPPPPPPPPPPPPPPPPPPPP                                        D     S  PKKKKKKKKKKKKKKKKKKKKKKKKKKKP                               PKKKKKKKKKKKKKKP
PPPPPPPPPPPPPPPPPPPPPPPPPPPPPPPPPPPPPPPPPPPPPPPPPPPPPPPPPPPPPPPPPPPPPPPPPPPPPPPPPPPPPPPPPPPPPPPPPPPPPPPPPPPPPPPPPPPPPPPPPPPPPPPPPPPPPPPPPPPPPPPPPPPPPPPPPPPPPPPPPPPPPPPPPPPPPPPPPPPPPPPPPPPPP
